6 12

4 4 4 4 4 4 4 4 4 4 4 3
3 1 3 1 3 1 3 1 3 1 3 1
2 4 0 0 2 6 2 2 6 2 2 1
0 1 3 1 4 1 2 4 2 1 4 1
3 5 0 1 3 9 0 8 1 1 1 2
4 0 4 3 4 2 4 5 4 1 4 6
3 1 3 5 3 1 0 4 2 0 0 7
