4 12

4 4 4 4 4 4 4 4 4 4 4 4
3 4 3 4 3 4 3 4 4 3 9 7
2 3 0 3 2 6 3 2 6 3 2 1
2 1 3 1 3 1 2 3 3 7 3 4
3 5 2 1 3 9 4 8 9 4 4 4
