4 12

4 4 4 4 4 4 4 4 4 4 4 3
3 1 3 1 3 1 3 1 3 1 3 1
2 2 0 0 2 6 2 2 6 2 2 1
0 1 3 1 3 1 2 1 2 1 1 1
3 5 0 1 3 9 0 8 1 1 1 2
