4 8

4 4 4 4 4 4 4 4
3 4 3 4 3 4 3 4
2 3 0 3 2 6 3 2
2 1 3 1 3 1 2 3
3 5 2 1 3 9 4 8
